Type,comment,like,share,Total_Interactions,Paid,Lifetime_Post_Total_Impressions,Lifetime_Post_Total_Reach
Photo,4,79,17,100,0,5091,2752
Status,5,130,29,164,0,19057,10460
Photo,0,66,14,80,0,4373,2413
Photo,19,325,49,393,0,13594,7244
Status,1,152,33,186,0,20849,10472
Status,0,161,31,192,0,22538,11844
Photo,3,113,26,142,0,8668,4694
Status,0,233,19,252,0,42334,21744
Photo,0,88,18,106,0,5590,3112
Photo,0,90,14,104,0,5133,2847
Photo,5,137,10,152,0,4896,2549
Status,4,86,18,108,0,19680,10060
Photo,2,40,12,54,0,2981,1722
Status,4,54,17,75,0,7509,3930
Photo,0,34,8,42,0,2825,1591
Photo,3,66,12,81,0,5066,2848
Photo,0,0,0,0,0,2467,1384
Link,0,16,2,18,0,6853,3454
Photo,0,72,24,96,0,4888,2723
Status,3,99,19,121,0,15294,8488
Status,0,88,18,106,0,15104,8284
Status,10,412,72,494,0,34143,19552
Photo,0,100,17,117,0,4306,2478
Photo,36,523,63,622,0,18264,9560
Photo,33,107,22,162,0,9390,4940
Photo,1,27,11,39,0,2929,1683
Photo,2,155,47,204,0,9578,5280
Photo,4,98,23,125,0,5318,3002
Photo,2,56,17,75,0,7149,3766
Photo,6,172,21,199,0,7808,4512
Photo,0,96,17,113,0,4628,2690
Status,11,227,31,269,0,33058,17576
Photo,1,44,14,59,0,6085,3290
Status,7,216,39,262,0,24198,13280
Photo,7,26,3,36,0,13989,7268
Photo,0,47,11,58,0,8387,4284
Status,4,174,36,214,0,30612,16576
Link,6,18,8,32,0,3481,1925
Photo,0,77,15,92,0,7329,3786
Link,1,12,1,14,0,3094,1536
Photo,1,48,9,58,0,3155,1728
Photo,9,202,31,242,0,8899,4894
Photo,4,64,19,87,0,5439,2935
Photo,4,66,13,83,0,4462,2425
Photo,2,164,54,220,0,10465,5812
Photo,0,40,13,53,0,4846,2545
Photo,3,76,11,90,0,4372,2257
Photo,2,60,7,69,0,5234,2352
Photo,19,77,23,119,0,6167,3416
Photo,0,48,7,55,0,4120,2149
Photo,0,53,17,70,0,3891,2168
Photo,7,84,28,119,0,5939,3102
Status,3,226,44,273,0,16362,9056
Video,2,99,13,114,0,30235,13544
Photo,0,0,0,0,0,2392,1228
Photo,4,85,8,97,0,59040,22984
Photo,0,56,8,64,0,2774,1445
Photo,2,29,7,38,0,8533,3754
Status,2,86,13,101,0,17827,8728
Photo,18,370,53,441,0,11123,5990
Photo,5,190,57,252,0,9193,4582
Status,2,99,16,117,0,13092,6692
Link,2,130,31,163,0,54779,21176
Photo,3,270,38,311,0,7955,4012
Photo,3,30,6,39,0,2838,1531
Photo,13,331,77,421,0,37240,24720
Photo,0,78,13,91,0,4545,2219
Photo,9,301,32,342,0,9303,4732
Photo,2,111,16,129,0,4239,2225
Photo,2,124,22,148,0,4943,2626
Photo,5,153,27,185,0,5744,3090
Photo,3,51,11,65,0,2548,1101
Photo,1,115,26,142,0,5230,2819
Photo,12,328,90,430,0,21893,12776
Photo,26,1505,95,1626,0,104952,68896
Photo,2,63,14,79,0,3174,1711
Photo,0,13,4,17,0,2544,1388
Photo,42,955,139,1136,0,111745,70144
Photo,9,181,32,222,0,7221,3674
Status,17,193,28,238,0,19556,9504
Photo,7,125,16,148,0,4469,2426
Status,4,217,50,271,0,27468,13872
Photo,2,28,4,34,0,3655,1673
Photo,4,117,18,139,0,4510,2428
Photo,0,15,2,17,0,2749,1592
Photo,1,431,26,458,0,57472,32208
Photo,0,7,0,7,0,1374,729
Photo,0,7,2,9,0,1570,834
Photo,0,6,2,8,0,1573,786
Status,6,186,40,232,0,30514,15816
Photo,1,1,2,4,0,1096,619
Photo,1,3,2,6,0,1071,617
Photo,0,7,2,9,0,1240,677
Photo,3,198,41,242,0,6647,3366
Photo,0,9,1,10,0,1443,747
Photo,0,4,1,5,0,1117,645
Photo,0,3,0,3,0,1510,754
Photo,0,8,2,10,0,1673,910
Photo,0,7,3,10,0,8239,3906
Photo,1,7,2,10,0,1158,659
Photo,0,11,1,12,0,1331,652
Photo,2,28,4,34,0,1565,861
Photo,0,56,12,68,0,7659,3690
Link,0,32,16,48,0,9463,4664
Photo,4,32,3,39,0,2427,1080
Status,0,129,25,154,0,17202,8896
Link,15,143,44,202,0,229733,68992
Status,2,227,36,265,0,25666,13152
Photo,0,189,15,204,0,44940,18120
Photo,0,80,14,94,0,3960,2291
Status,3,148,28,179,0,20691,10744
Photo,24,302,41,367,0,112830,39984
Photo,2,166,32,200,0,7444,4010
Photo,7,161,25,193,0,20151,8612
Photo,13,319,55,387,0,10282,5568
Photo,0,54,16,70,0,2999,1685
Photo,16,117,30,163,0,7094,3756
Photo,1,115,21,137,0,4862,2656
Photo,30,187,35,252,0,9493,5086
Photo,6,363,40,409,0,14948,9384
Photo,6,244,32,282,0,7255,3992
Photo,22,290,98,410,0,13633,7512
Status,4,243,41,288,0,21080,11096
Photo,144,1622,208,1974,0,68290,41984
Photo,3,188,26,217,0,8039,4480
Photo,2,30,6,38,0,2874,1543
Status,38,163,27,228,0,41906,21256
Photo,6,179,40,225,0,7829,4484
Photo,5,204,34,243,0,8105,4398
Photo,2,234,40,276,0,10830,6208
Photo,7,250,42,299,0,8533,4518
Photo,4,154,36,194,0,6518,3582
Photo,4,102,8,114,0,38806,14152
Video,6,345,121,472,0,56950,30624
Photo,11,68,11,90,0,4223,2363
Photo,0,62,10,72,0,4005,2232
Photo,5,223,35,263,0,7217,4048
Photo,0,61,6,67,0,2968,1804
Photo,3,146,15,164,0,5388,3100
Photo,9,766,43,818,0,33643,19648
Photo,0,63,7,70,0,3721,2295
Photo,6,442,42,490,0,76659,34512
Photo,9,278,43,330,0,8730,5282
Photo,2,64,7,73,0,3130,1809
Photo,1,52,7,60,0,3124,1920
Photo,33,1155,102,1290,0,64850,33536
Photo,0,40,5,45,0,6557,3376
Photo,4,220,19,243,0,205934,72864
Photo,2,114,16,132,0,5682,3358
Photo,4,859,68,931,0,121234,50640
Photo,5,137,20,162,0,6218,3734
Photo,1,54,11,66,0,4220,2594
Photo,2,264,21,287,0,12978,7980
Photo,3,36,11,50,0,2845,1659
Photo,2,114,10,126,0,64746,28880
Photo,2,17,9,28,0,2327,1330
Status,41,15,1,57,0,26000,14424
Photo,3,87,10,100,0,26728,14200
Photo,16,227,28,271,0,9874,5746
Photo,2,86,8,96,0,4372,2540
Photo,6,179,27,212,0,7241,4324
Status,1,74,11,86,0,14305,8260
Photo,2,80,21,103,0,9084,5046
Status,9,95,17,121,0,25269,15296
Photo,64,367,25,456,0,21863,14824
Photo,9,102,19,130,0,5699,3504
Photo,2,113,20,135,0,5058,2822
Photo,0,94,20,114,0,5063,2973
Photo,1,43,10,54,0,6691,4592
Photo,1,98,21,120,0,5278,3176
Status,3,13,1,17,0,19279,10956
Photo,12,237,45,294,0,19744,10888
Photo,4,112,23,139,0,6316,3594
Photo,2,101,25,128,0,6166,3384
Photo,6,535,83,624,0,35161,19968
Photo,4,118,22,144,0,8499,4892
Status,9,484,79,572,0,33613,17360
Photo,4,154,30,188,0,66824,44464
Photo,0,73,15,88,0,5188,2881
Photo,0,96,19,115,0,6503,3460
Photo,1,98,19,118,0,5656,3406
Photo,6,194,34,234,0,43464,26944
Photo,6,226,42,274,0,9321,5292
Photo,10,755,58,823,0,82011,54256
Photo,10,167,26,203,0,7774,4220
Photo,9,152,41,202,0,8360,4666
Photo,13,234,43,290,0,41650,28208
Photo,2,61,16,79,0,5461,3330
Photo,7,529,60,596,0,55398,38576
Photo,2,75,24,101,0,12735,7232
Status,13,61,13,87,0,16978,10188
Photo,26,162,7,195,0,11881,6408
Photo,1,143,27,171,0,9098,5458
Photo,18,46,7,71,0,6194,3706
Status,36,98,14,148,0,31448,18320
Video,23,204,44,271,0,277100,139008
Photo,7,148,39,194,0,191324,109056
Photo,1,40,8,49,0,4908,3212
Photo,1,71,17,89,0,4909,3046
Status,0,104,13,117,0,20327,12044
Photo,11,129,12,152,0,47721,28112
Status,4,72,18,94,0,14847,8628
Photo,103,469,33,605,0,29062,20896
Photo,5,57,5,67,0,4072,2402
Photo,0,23,2,25,0,3289,1729
Photo,5,141,26,172,0,7127,4320
Photo,0,19,5,24,0,4410,2585
Photo,1,71,23,95,0,5969,3322
Photo,0,72,21,93,0,5807,3600
Photo,5,54,7,66,0,21564,11620
Photo,5,93,19,117,0,7004,4248
Photo,0,62,10,72,0,4388,2763
Photo,0,78,16,94,0,5396,3558
Photo,0,14,1,15,0,14480,8324
Photo,11,231,43,285,0,11469,6952
Photo,0,148,7,155,0,80871,58304
Photo,2,208,28,238,0,8303,4762
Photo,12,148,28,188,0,10217,6150
Photo,3,142,18,163,0,29650,22464
Photo,8,107,20,135,0,6295,3754
Photo,0,22,3,25,0,7998,4452
Photo,2,84,13,99,0,5525,3576
Photo,2,59,12,73,0,4794,3028
Photo,9,186,23,218,0,70212,47376
Photo,0,58,17,75,0,5113,3234
Photo,2,74,14,90,0,5553,3322
Photo,2,180,44,226,0,11525,6768
Photo,0,36,5,41,0,18474,13544
Photo,2,51,6,59,0,5659,3418
Photo,20,1372,47,1439,0,104966,56672
Photo,2,33,10,45,0,5405,3110
Photo,1,79,17,97,0,6486,3806
Photo,16,617,58,691,0,55633,39040
Photo,20,199,32,251,0,34095,21248
Photo,1,107,26,134,0,8025,4344
Photo,0,50,10,60,0,4698,2718
Photo,0,64,20,84,0,5630,3024
Status,2,55,10,67,0,17099,10152
Photo,1,142,37,180,0,8090,4708
Photo,2,72,9,83,0,4642,2772
Photo,4,79,16,99,0,4954,2812
Photo,25,307,58,390,0,32576,18056
Photo,6,212,36,254,0,8745,5016
Photo,2,95,17,114,0,6181,3528
Photo,5,194,33,232,0,11509,6444
Link,3,46,14,63,0,19301,12540
Photo,37,821,90,948,0,65149,38960
Photo,1,58,13,72,0,5067,3144
Photo,45,1639,122,1806,0,124753,81856
Photo,3,155,32,190,0,10164,5728
Photo,4,400,25,429,0,25542,18552
Photo,2,98,18,118,0,7165,4132
Photo,12,138,38,188,0,9209,4910
Photo,3,148,16,167,0,7633,4202
Photo,2,267,40,309,0,10441,5976
Photo,1,144,29,174,0,8962,5206
Photo,25,256,54,335,0,12066,6984
Photo,3,72,24,99,0,10300,6000
Photo,0,87,18,105,0,5797,3332
Status,1,129,36,166,0,16811,9232
Photo,9,194,33,236,0,51899,24264
Photo,1,124,32,157,0,7594,4280
Photo,4,304,47,355,0,11859,6692
Photo,4,41,9,54,0,15350,11336
Photo,45,407,76,528,0,55202,28352
Photo,2,93,26,121,0,15194,9084
Photo,0,66,13,79,0,9835,6596
Photo,8,186,18,212,0,251269,128064
Photo,11,235,34,280,0,9970,5994
Photo,1,64,22,87,0,10417,6172
Photo,2,92,28,122,0,8198,4986
Photo,3,53,13,69,0,10701,6668
Photo,0,48,8,56,0,45508,35008
Photo,0,35,5,40,0,12695,9880
Photo,4,37,3,44,0,5953,3334
Photo,1,96,18,115,0,26026,20920
Photo,1,57,13,71,0,6406,3884
Photo,3,114,21,138,0,7057,4240
Photo,1,51,6,58,0,6156,3544
Photo,5,81,11,97,0,110172,71360
Photo,1,71,18,90,0,6333,3824
Photo,9,164,52,225,0,11079,6360
Link,1,379,40,420,0,94172,70912
Photo,1,52,24,77,0,7253,4552
Photo,1,63,26,90,0,7004,4390
Photo,2,97,25,124,0,7716,4770
Link,1,36,7,44,0,42092,34192
Photo,4,138,26,168,0,8769,5302
Photo,7,142,24,173,0,9301,5560
Photo,1,75,15,91,0,6769,4406
Photo,7,227,15,249,0,1110282,49632
Status,3,25,6,34,0,14759,9120
Photo,0,0,0,0,0,2474,1874
Photo,1,27,11,39,0,7073,4122
Photo,0,39,14,53,0,8238,5080
Photo,0,61,13,74,0,7333,4068
Photo,0,32,7,39,0,6079,3272
Photo,0,2,0,2,0,570,238
Photo,8,109,3,120,0,5900,3358
Photo,0,32,6,38,0,11941,6400
Link,2,68,15,85,0,10885,6876
Photo,0,6,1,7,0,746,391
Photo,4,213,13,230,0,22468,10844
Photo,0,2,0,2,0,9067,5132
Photo,0,3,0,3,0,6971,3772
Link,0,6,0,6,0,5144,2933
Photo,0,4,0,4,0,7469,4094
Photo,0,4,1,5,0,726,452
Photo,12,211,14,237,0,23855,11420
Photo,1,15,1,17,0,10510,5704
Photo,11,95,4,110,0,12811,7192
Photo,0,136,13,149,0,457509,122944
Link,2,32,15,49,0,10083,5730
Photo,1,76,9,86,0,7960,4898
Photo,1,28,7,36,0,7355,4118
Photo,10,664,97,771,0,191207,34480
Photo,1,62,10,73,0,9940,5338
Photo,0,48,20,68,0,9411,5312
Photo,3,148,21,172,0,33000,20528
Photo,0,96,29,125,0,11459,6416
Photo,4,49,15,68,0,10634,5786
Photo,3,98,27,128,0,10508,5878
Photo,14,198,70,282,0,16535,9528
Photo,5,159,53,217,0,14157,8500
Photo,6,154,18,178,0,42940,28128
Photo,5,128,32,165,0,12627,7228
Photo,146,1546,181,1873,0,665792,55520
Photo,5,79,11,95,0,10115,5880
Photo,9,268,36,313,0,453213,158208
Photo,4,128,38,170,0,10832,6484
Photo,5,264,36,305,0,31467,15288
Photo,10,193,61,264,0,16779,9528
Link,4,114,13,131,0,14986,9356
Photo,7,160,57,224,0,13264,7732
Photo,0,46,15,61,0,8893,5240
Photo,0,73,13,86,0,39641,21928
Link,1,101,5,107,0,7927,39600
Photo,1,74,31,106,0,8745,5536
Photo,7,84,36,127,0,10325,6056
Photo,56,360,99,515,0,20696,11484
Photo,3,187,36,226,0,9456,66784
Photo,2,69,26,97,0,8779,5526
Photo,2,82,24,108,0,8367,5040
Link,0,12,2,14,0,8371,5168
Photo,2,56,25,83,0,8030,5034
Photo,1,44,21,66,0,7491,4908
Photo,21,277,80,378,0,17442,9700
Photo,1,74,28,103,0,7754,4800
Photo,1,79,30,110,0,8703,5280
Link,0,128,9,137,0,5808,45920
Photo,17,185,55,257,0,13960,8412
Photo,10,125,41,176,0,9218,5400
Photo,5,53,26,84,0,7536,4684
Photo,0,53,22,75,0,6229,3480
Photo,4,93,18,115,0,7216,3778
Photo,7,91,38,136,0,7564,4156
